NO textures/mossed_wall.xpm
SO textures/normal_wall.xpm
WE textures/sign_wall.xpm
EA textures/torch_wall.xpm

C 35,19,73
F 15,6,40

11111111111
111111000111
1111100000111
1111000N000111
111000000000111
110000000000011
100001111100001
110000111000011
111000010000111
11110000000111
1111100000111
111111000111
11111111111

