NO textures/mossed_wall.xpm
SO textures/normal_wall.xpm
WE textures/sign_wall.xpm
EA textures/torch_wall.xpm

F 128,128,128
C 0,0,0

111111111111111111111111111111111
1       1000000000110000000000001
1       D011000001110000000000001
1       1001000000000000000000001
111111111011000001110000000000001
100000000011000001110111111111111
11110111111111011100000010001
11110111111111011101010010001
11000000110101011100000010001
10000000000000001100000000001
10000000000000001101010010001
11000001110101011111011110N0111
11110111 1110101 101111010001
11111111 1111111 111111111111
