NO textures/normal_wall.xpm
SO textures/torch_wall.xpm
WE textures/sign_wall.xpm
EA textures/mossed_wall.xpm

F 18,53,25
C 153,204,255

111111111111
1         11
1          1
1111111D1111
10S000000001
1111111D1111
11         1
111111111111
