1111111111111111111111111111111111
1C0000000000000C000X0C0000000000C1
10100101001000001010010X0000010100
1010X1001010101X001001000X01111111
1P00000X0C00C00000000000000X0000E1
1111111111111111111111111111111111
