F 76,76,76
C 99,99,99

NO textures/mossed_wall.xpm
SO textures/normal_wall.xpm
WE textures/sign_wall.xpm
EA textures/torch_wall.xpm

1111111111111111111
10W1001001001000001
1011000001000001001
1001001001111101111
1001111000001001001
100D000000000001001
1001111111111001001
1111000000000001011
1000000001000000001
1111111111111111111

